MMLLLCGGGGGLMLGGGGGGGGGGGGLLMMMMMLL
MMLCGGGGGGGLLGGGGGGGGGGCGGGHLLLLLGG
MLGGGGGAGGGRGGGGGGGLLCGGGGGGHGLLGGG
MLRRRRRRRRRRGGGGGGLMLLLGGGGGGGLLLGG
LGGGGGGGGGGGGGGLLMMMMMLLGGGGGGGGGGG
LGGGGGGGGGGGGLLLMMMMMLLGGGGGGGGGGGG
GGGGLLLHGGGGGGLLLMMMMLRRRRRRRRRRRGG
GGGGLLHGGGGGGGGGLMMMMMLLGGGGGGGGRRR
GGGGGGGGGGGGGGGGCGMMMLGGGCCGGGGGGGG
BBPBBBBBBBBGGGGGGGGLLGGGGGGGGGGGGGG
OOOOOOOOOOOBGGGGGGGGGGGGGGGGGGGGGGG
OOOOOOOOOOOOBGGGGGGGGGGGGGGGGGBBBBB
OOOOOOOOOOOOOBBBBBBBBBBPBBBBBBOOOOO
OOOCGOOOOOOOOOOOOOOOOOOOOOOOOOOOOOO
OOGCGBOOOOOOOOOOOOOOOOOOOOOOOOOOOOO
OOOGGBOOOOOOOOOOOOOOOOOOOOOOOOOOOOO
OOOOOOOOOOOOOOOOOOOOOOOOOOOOOOOOOOO