MMLLLCGGGGGLMLFFFFFFFFGGGGLLMMMMMLLFFFFFFFLMM
MMLCGGGGGGGLLGGGGGGGGGGCGGGHLLLLLFFFFFFFLMMMM
MLGGGGGAGGGRGGGGGGGLLCGGGGGGHGLLFFGGHGGFFLMMM
MLRRRRRRRRRRGGGGGGLMLLLGGGGGGGLLLFFFGGGHFFLMM
LGGGGGGGGGGGGGGLLMMMMMLLGGGGGGGGGGGGGGGFFLLMM
LFGGGGGGFFFFFLLLMMMMMLLFFFGGGGGGCGGGGGFFLLLMM
FGGGLLLHGGFFFFLLLMMMMLRRRRRRRRRRRCGGGGGGFFFLL
GGGGLLHGGGGGGFFGLMMMMMLLGGGGGGGGRRRRRRRRGGFFF
GGGGGGGGGGGGGGGGCGMMMLFFGCCGGGGGGGGGGGGRGGGGF
BBPBBBBBBBBGGGGGGGGLLFFFGGGGGGGFFGGGGGGRGGGGF
OOOOOOOOOOOBGGGGGGGGGGFFGGGGGGGGGGGBBBBRBBBBB
OOOOOOOOOOOOBGGGGGGGGGGGGGGGGGBBBBBOOOOOOOOOO
OOOOOOOOOOOOOBBBBBBBBBBPBBBBBBOOOOOOOOOOOOOOO
OOOCGOOOOOOOOOOOOOOOOOOOOOOOOOOOOOOOOOOGGFOOO
OOGCGBOOOOOOOOOOOOOOOOOOOOOOOOOOOOOOBGGGGGOOO
OOOGGBOOOOOOOOOOOOOOOOOOOOOOOOOOOOOOOBBBOOOOO
OOOOOOOOOOOOOOOOOOOOOOOOOOOOOOOOOOOOOOOOOOOOO