MMLLLGGGGGGLMLGGGGGG
MMLGGGGGGGGLLGGGGGGG
MLGGGGGGGGGRGGGGGGGL
MLRRRRRRRRRRGGGGGGLM
LGGGGGGGGGGGGGGLLMMM
LGGGGGGGGGGGGLLLMMMM
GGGGLLLGGGGGGGLLLMMM
GGGGLLGGGGGGGGGGLMMM
GGGGGGGGGGGGGGGGGGMM
BBBBBBBBBBBGGGGGGGGL
OOOOOOOOOOOBGGGGGGGG
OOOOOOOOOOOOBGGGGGGG
OOOOOOOOOOOOOBBBBBBB
OOOOOOOOOOOOOOOOOOOO
OOOOOOOOOOOOOOOOOOOO